##########
#        #
# X      #
#    OX O#
#  # P  ##
####     #
#     X O#
##########
